1111111111111111111111111111111111111111111111111
100000000K011111100000000000000001111111110000011
1011011111011W111C1110110000000000111111100000001
10111110000010011110100110000001000111110000C0001
1C1C010011111100000011011100001110001111100000001
1111010111000001101111011110011111000111110000011
1000000000011111001000011110111111100011110111111
1011111011111111111011111000011111000011000101001
1010001010K00000000011101100001110000110000111101
10101010101111111111110000000001000C0000000011111
1010101010111100000000000000000000000000000000011
1P10100010111101011110000110000010001100000001001
1110101000111101000111001111000111001001001001001
1C001010111111E111C1111111011011111111111111C1001
1111111111111111111111111111111111111111111111111
